?inside:false
?safe:false
/L
10,10,16,16,16,16,16,10,10,10,0,0
10,1,16,16,16,16,16,1,1,10,0,0
10,1,15,13,12:1,13,15,1,1,10,0,0
10,2,2,7:1,17,1,1,1,1,10,0,0
10,2,2,2,17,1,1,1,1,10,0,0
10,2,2,2,17,1,1,1,1,10,0,0
10,1,1,1,17,1,1,1,1,10,0,0
10,1,1,1,1,1,1,1,1,10,0,0
10,1,1,1,1,1,1,1,1,10,0,0
10,1,1,1,1,1,1,1,1,10,0,0
10,10,10,10,10,10,10,10,10,10,0,0
0,0,0,0,0,0,0,0,0,0,0,0
//


/T
/[1]
#/room1.txt
~2,7
/#
//

/D
/[1]
#Be cautious printermon like tall grass
//

/P
#0,2
~2,3
//
