?inside:false
?safe:false
/L
3,3,3,3,3,3,3,10,0,0,0
16,16,16,16,16,3,3,10,10,10,10
16,16,16,16,16,3,3,1,1,1,1
15,14,12,14,15,3,3,1,1,1,1
1,1,2,1,1,3,3,1,1,1,1
1,1,2,1,1,3,3,1,1,1,1
3,3,3,3,3,3,3,3,3,3,3
1,3,1,1,16,16,1,1,16,16,1
1,3,1,1,16,16,16,16,16,16,1
1,3,1,7:2,15,14,12,13,14,15,1
1,3,3,3,3,3,3,3,3,1,1
//

/D
/[1]
#Bees
/#
/[2]
#Fun house
/#//