?inside:false
/L
1,1,1,1,1,1
1,2,2,2,2,1
1,2,3,3,2,1
1,2,7:1,3,2,1
1,2,2,2,2,1
1,1,1,1,1,1
//

/D
/[1]
#Woo
/#//